11111111111111111111111111111
12000000111111111111110000011
11111101111100000033000111011
11001001111111111011111111011
11100011000000000000111111011
11001100011111111111011111011
11011001111111000000001111011
11000011111111011111101111011
11111111111111000000001111011
11111111111110011111111111011
10010001000300111111111111011
11000100001110011111111111011
11111111111111001111111110011
11111111111111100111111110001
11111111111111110011111110001
11111111111100000000000000001
11111111111111111111111111111
