11111111111111111111111111111111111
12000000000000000001110001100001111
11111111111111111101000110001101111
11100011110001111100111100011000111
10001000000111111001100011110010011
11101011110000110011001001100011001
11101000111110000110011000001001011
11101110001110011100110010011000011
11100000100000000001100111001010011
11111111111111111000101111100111011
11111111111111111110001111110100011
11111000011111111110000111110101011
11110000000000000030000000000000011
11111111111111111111111111111111111
11111111111111111111111111111111111
