11111111111111
12001000010001
10101000010101
10100000010101
10101000010101
10101000000101
10101111110101
10131000010101
10101000011101
10100000010101
10101000010101
10101000010101
10111011110101
10100000010101
10101111010101
10101000010101
10101111110101
10100000000101
10111111110101
10000000010001
11111111111111
